-----------------------------
-----------------------------
-----------------------------
----------DDDDDD-------M-----
----------DDDDDD-------D-----
--------------------DD-------
--------C--------DD---------
DDDDDDDDDDDDDDDDDDDDDDDDDDDDD
DDDDDDDDDDDDDDDDDDDDDDDDDDDDD