--------------------
--------------------
--------------------
--------------------
--------------------
--------------------
-----DDDDDD-------M-
---------------DD---
-B--P--C-----DD-----
DDDDDDDDDDDDDDDDDDDD
DDDDDDDDDDDDDDDDDDDD
